Kapitel 1
Bezeichnen – kalla
der Begriff – begrepp
der Gesamtbereich – samlingsnamn
die Gesetzlichkeit – laglighet
erfassbar – upptäcksbar
der Verlauf - Förloppet
überzeugen – övertyga
misslangen – misslyckas
üblicherweise – generellt
gegliedert – indelat
inwieweit – till vilket grad
die Erzeugung – skapelse
vermeintlichen – antaget
erforderlich – tillräcklig
abgeleiteten – härledd
sich bemühen um – anstränga sig
das Einflussbereich – inflytesområde
das Erkenntnis – insikt
überliefern – föra vidare, efterlämna
die Neubesinnung – nytänkande
der Geisteswissenschaft – Humaniora
Wirtschaftswissenschaft – Ekonomistudier
die Völkerkunde – etnograf
die Säule – pelare
die Tätigkeit – sysselsättning
sich auffächern – expandera
die Aufklärung – Upplysning
das Gestirn – himmlakropp
die Heilung – läkning
die Vererbung – ärftlighet
die Weltdeutung – världsbild
die Herrschaftsvorstellung – Härskarskapsperception
beeinflussen – påverka
Wissengrundlage – grundlag
das Erfordernis – krav
die Vorrichtung – anordning
umschreiben – skriva ned
Fragestellung aufwerfen – ställa en fråga
der Gesellschaft – bolag, samhälle, sällskap
angesichts – med hänsyn till
gegenwärtig – för tillfället
entscheidend – avgörande
die Bewältigung – bemästra, besegra, överkomma
Darbietungen -	föredrag, utläggningar
Gehoben - högre stil
die Sitzung -	sammanträde, möte
der Bericht - rapport
vergleichen - jämföra
Anforderung  - krav
Anwesenheit - närvaro
Hinblick	 - med tanke på, med anledning av
Erledigen - ordna upp, klara av
Gewiss - vara säkert på något
Bedarf - behov
Entwurft - utkast
bzw, beziehungsweise - respektive
die Berücksichtigung - hänsyn
unbedingt - absolut
treten - gå, stiga, komma, träda
gewöhnlich - vanlig
der Wasserdampf  - ånga (vatten)
der Kunststoff - plast
das Glas - glas
die Werkstatt - verkstad
das Gerät - anordning, enhet
die Faser - fiber
der Gegenstand - föremål, sak; ämne
das Gehäuse -	hus; fodral, kåpa
der Kunststoffschaum - plastskum
das Material - material
das Gewebe  - vävnad; väv
das Kupfer  - koppar
das Molekül  - molekyl
der Kreis - cirkel
die Hinsicht - avseende
die Plastizität -	plasitisitet
der Zustand  -  tillstånd, skick
das Experiment  -experiment
die Form - form
das Produkt - produkt
der Anteil - andel
das Pulver - pulver; krut
der Schutz  - skydd, beskydd
der Körper -	kropp
das Labor -	laboratorium
die Erkenntnis  - insikt; kunskap
der Vorgang  -  händelse
der Kern  - kärna, centrum
der Mittelpunkt  -medelpunkt
der Speicher  - magasin, lagerlokal, vind; datorminne
der Vorstoss  -  initiativ
das Zahnrad - kugghjul
der Weltraum - världsrymd
der Mikrokosmos - mikrokosmos
das Ausmass - omfattning; utsträcking
das Gesetz - lag
der Teil  - del; part; andel
das Gebiet - område
der Bereich - område
der Zusammenhang  -  sammanhang, samband
der Nachweis  - bevis
der Strom  -  ström
das Rohr  - rör
sich herausstellen  - visa sig (att)

Kapitel 2

Im Laufe – under loppets gång
Vielzahl – flertalet
Aufgegliedert – uppdelad
Jeweils – i varje fall
Erforschen – utforska
Der Vorgang - händelse
Der Zustand – tillstånd
Betrieben – driva
Strebende – strävande, sökande
Der Sinn – sinne
Die Wahrnehmung – medvetenhet, uppfattning
Spiegeln – spegla
Gefolge – följeskap, efterkommande
Bestätigen –  bli bevisad
Ungeahnt – oförutsedd
Jahr für jahr – år efter år
Mass an – mängd av
Ungemessen – omätt
Die Entfernung – distans
Vorstoss – trycka, föra framåt
Aufwand – kostnad, möda
Volkswirtschaft – ekonomi
Die Bewältigung – hantering, täckning
Annehmen – acceptera, ta
Aufnehmen – includera, få, börja
Einnehmen – ta, fånga, occupera
Teilnehmen – dela
Übernehmen – acceptera, anta, överta
Wahrnehmen – ta tillvara på, iakta
Werdegang – bakgrund, karriär
Sich beschäftigen – ta itu med
Das Hebelgesetz – principer av nivå
Die Lichtbrechung – reflektion
Der Auftrieb – peppa, stimulera, lyfta
Das Vermögen – förmåga, kapital
Die Erscheinung – uppträdande, utseende
Der Mittelpunkt – medelpunkt
Sich erweisen – visa sig
Die Grundlage – basis
Kennzeichnen – utmärka, känneteckna
Die Auffindung – upptäckt
Verheerende – förödande
Eindringen – invardera, penetrera, inflitrera

Kapitel 3

Das Bedürfnis – behov
Ansprüchen – anspråk
Das Ensemble – medverkande
Die Anschauung – idé, utsikt
Bummeln – strosa
Entscheiden – besluta
Tropfen – droppa
Vorwiegend – huvudsakligen
Der Wert – värdet
Widerspricht – motsäger
Glechermassen – lika, motsvarande
Die Anforderung – förfrågan
Der Zweck – målet
Entsprechen - överensstämma
Die Alterung – åldrandet
Jeweilig – motsvarande, i synnerhet
Streben – sträva
Abbauen – förstöra, riva
Anbauen – bygga på
Aufbauen – bygga upp, etablera
Ausbauen – bygga ut
Umbauen – bygga om

Kapitel 4

Aufgewühlt – uppjagad
Der Broterwerb – leverbröd
Häufig – ofta
Vorhanden – tillgänglig
Der Raubbau – överarbetad, utmattad, tömd
Zerschneiden – urholka, klippa ur
Die Grünlandnutzung – jordbruk
Gefährdet – utsatt, hotad, sårbar
Der Kreislauf – kretslopp
Verseuchen – försmutsa
Entziehen – dra ur, ta tillbaka
Abstellen – koppla från
Bestellen – beställa
Darstellen  - illustrera
Einstellen – justera, anställa
Feststellen – fastställa
Herstellen – framställa
Umstellen – skifta, omringa
Vorstellen – föreställa 
Absehen – förutse
Sich ansehen – se över
Durchsehen – se igenom
Einsehen – inse
Übersehen – se bort från ngt
Vorsehen – förse

Kapitel 5

Erschliessen – exploatera, utveckla
Geruchlos – luktfri
Bezeichnet – beteckna
 Der Verbrauch – konsumtion
Der Rohstoff – råvara
Die Gegebenheit – fakta
Der Gegenstand – föremål
Der Werkstoff – material
Zweckmässig – passande
Ausgesprochen – rakt ut sagt
Beständig – stadig
Weder – varken
Das Material – material
Geeignet – passande, kvalificerat
Empfindichen – rå, känslig
Das Spielzeug – leksak
Gehäuse – fodral
Die Zugfestigkeit – brottgräns
Der Querschnitt – profil, genomskärande
Das Gewebe – vävnad
Die Schmierung – smörjning
Der Schall – ljud, akustik
Die Oberfläche – yta
Geringe – små
Die Schicht – skickt, lager
Abschliessen – låsa, avsluta
Anschliessen – ansluta
Aufschliessen – låsa upp
Ausschliessen – utesluta
Beschliessen – besluta
Erschliessen – bemaktiga

Kapitel 7 

Die Spaltbarkeit – delbarhet
Erscheinen – verka, se ut som
Herkömmlich – gammalmodig
Ungewöhnlich – ovanlig
Der Aufwand – insatsen
Fördern – driva framåt
Herbeischaffen – komma vid
Die Entsorgung – hantering(avfall, sopor)
Aufwendig – utförlig, kostsam
Zusätslich – ytterliggare
Die Asche – aska
Einerseits – å ena sidan
Anderseits – å andra sidan
Dauerhaft – hållbar
Die Versorgung – tillgången
Der Fachmann – specialist, expert
Die Anreicherung – berikning
Überführen – överföra, förmedla
Der Erfolg – framgång
Die Schlagzeile – rubrik
Der Massstab – mätstav
Einsetzen – sätta in
Ersetzen – ersätta
Fortsetzen – fortsätta
Freisetzen – frisätta, släppa fri
Übersetzen – översätta
Umsetzen – omsätta, omvandla
Voraussetzen – förutsätta
Zersetzen – bryta ned
Etwas bewirken – orsaka
Sich auf etwas auswirken – att efterverka på något
Gasförmig – gasformad
Auswechseln – utbyta
Der Unfall – olycka
Gewährleisten – försäkra
Der Wärmeleiter – värmeledare
Die Kühlung – kylare, kyl
Riesig – enorm
Die Quelle – källa
Entströmen – läcka
Auftreten – uppstå
Bestehen aus – bestå av
Entstehen durch, bei – uppstå
Feststehen – stå vid, stå fast vid
Überstehen – motstå, klara av, övervinna
Verstehen – förstå
Beitragen zu – bidra till
Betragen – uppgå till
Beauftragen – delge, tilldela
Ertragen – utstå
Übertragen – revidera, sända(radio/tv)

Kapitel 9

Der Arbeitgeber – arbetsgivare
Die Belastbarkeit  - motståndskraft, spänst
Die Organisationsfähigkeit – organisationsegenskaper
Dienstzeiten – arbetstider
Das Empfehlungsschreiben – rekommendationsbrev
Führungseigenschaften – ledarskapsförmågor
Die Schichtarbeit – skiftarbete 
Die Unternehmenskultur – företagskultur
Die Vergünstigung – fördel
Zielorientiert – målorienterad
Empfänglich – känslig









